EA ./textures/backroom.xpm
NO ./textures/backroom.xpm
SO ./textures/backroom.xpm
WE ./textures/backroom.xpm

V

F 245,218,137
C 245,218,137


1111111111111111111111111111111111111111111111111111111111111111111111111111111111111111111111111111
1001100101010000101100001001000000010001010001100000001O10000011000000111000111000000000010101001001
1010010100010001001000000001100110000100010000010000011000000100000010000000000000111101000010011101
1100101101000000011111111001000010100000000000010001100001010100101000010101010010011001001001010111
1010000010000110001011010100000010010001011000010000110000000000010001010000000100100000111000001001
1100100110001101010000010011110010100100010101000110110000110101010010010000011000100010000100100001
1101000011111000110000000110010001010010001010011110000101001100100000000010000010110001111100000001
1001001000001110000000011100000000000100101100001000100100000001000100101010100110010100110011001001
1000101001100100001111000000000110000110000101110110010101000000000000001001100001111000100011001101
1100000000000001000001011100101001000000011000000110010001000110010100001100001000000001011010000001
1000001111000010011000101000110010100010001000110010100001010100010000110100110101000010100000000001
1011101100100100010000100001000000000100011010011100001110010100010010010001011001010001011100100101
1101100000100010000010000111011000010001010000001100100000001100110000111100010000110000100100110011
1101110101000010000010100100001001011010000000110000000010001001001000100001011001011100001000101101
1101101001000000011100011001010000001100101010100111001011110001000001000001101001000000000101101001
1011011010011001000001011100000010010000101000000101000101010100000000001010000110000100001011000001
1001101010010100001100100100100000001100010010000100000001111000110100000100101001000100001001000001
1100110000000111000110111100100000101000010010110100001011000001000000100000000100100011010010001101
1100110001001001101000100010010100000000001010000000010100011110010100100000000001100001011110110001
1010010010101000100001011000001110100000010000000101010110000000101111001000000101011110000001010011
1000000001100011110011000000000011001101001101010100101010101110000011000100100000101000000110000101
1000010010001010101011000001010011000000000110110000000101010010000001001100110000101010001001101001
1000000000101101001101000110100011000110011000110101110011000000000101000101100001001000111000010011
1001100000011101100001101010000110001000000000000001111110110011000000110011000101000000010011000111
1001001000110010000101000001000000000000000000000100010010001001100000000001000110001101011000010001
1010000011001001000110111100010100100010000010100000010000001000000001001110101001001010100101110101
1011010000100010101001100000000101000000000000010001000100000011100100000110101000000010010011101001
1101010000010000000000010101001000001000001100000001100100000000000010001000111000100101000000111001
1001100100111000000001010001011000000000010000100001100011010001110101001000011010010011000111100101
1001001100000000000100000000001000000001100000101100000101100000100010011001100110100010010000001001
1100000010010000000000101111101000001110110001000000000010101010011000100111000000010000011100110001
1000100001000000010010010001000010100000010000111011111100101100010011101101100010001111010010001011
1100100001010011110100000010010000010001000100010000011010001101001110011111010010010010110010011001
1011001000000101000001010000111000001000010010001000111101001010010000000010010001111110010001000001
1010100010011000100000011001010100000011011110010000100000000100101110000010001001100100101000010011
1000000010100000001001101100110011110111010110111110010100001101000100001110010100101000010001110001
1100011001100000101000011110000110101000000001110100000000000101000011010000010001100010010101110001
1000000001000011111000010111110101000010000010010000100101010101110010000101010010000000010110000001
1010100000100000000101110010100001100000100010001000000000111110100101001001000111101000000011000101
1100101011000000010001001010110000001011001001001110010011001010000100101100100000011011110100110011
1000100000010110000100101000101100000001010100010110001000000011010100000000010001111110000101010111
1001000001111000001000000111100010001000000000100101101111000001000000000000000101001001010001001011
1010011011000000110011011001100010001010111001111010100100001110000101000010100110100000101000001011
1001010001000000010010100011010011100101100100010100001101010110010000101011011000001000010010101001
1000010110101011010000010000000100100000101110110101101011001011100100000000111110000100010000010011
1010000100101000100000100010101010001100000100010001010110000011000000101101001001110010000010000001
1010100000100000000000101101110010010000111000000001000000010000000011001101110000101000000010110101
1110010000000101000110001111000100011010011000001000001110001100101001010010000000111011000000000011
1100000001010101101000100000010010000100000111010000101010001000100110001011000001001000000011100001
1010000010101001110100001000001100000010000000000100010100001110010000100000000000111000100001100001
1000000101100001100101010010110000010000001000100100100010100101000010010001001010010010011000111001
1000000110101110000001011101011000100010101000100010101001001001111001110100000010010100110000000011
1011010010000000000010001111111101000110000100000100010001000001100111000000010101100010100001001001
1000000100010000110001100000011000010000100101000001101100000000111000100101101000010010001010001111
1010000000100001000101001000011101000011010001000010000110110111000100000000001101000010110001000101
1000101001000010001000001000101100010100100010000011100000000000001001110000110010000000100000110011
1001110111000000011001100001010011100100000100010000000000001000001100110001101000000110010000111101
1000000010111110011101100010001110100010000100000100000000000000110011010000100001101010001000010011
1001110000101100010000000001000000100000101000101010000000101000000001110000000010000100100101000111
1000011000000011110000001000000111111100101100101011000000000001001101100001010000011010000111000001
1101100000101010001011010011010000000000001101000011010110100100000001011010001110000010000000001101
1110110000101000010011011000000000000011110101101010100010100000010000000000001000100100111010011001
1000000000001000111101011010010010000001101010100100111011100100000110010011010001000010110000011001
1000010011000010101101000110010001101000000000100000101101100001001010010010000110100001101100100001
1001110111000100000001001000101010110001001000100111100100000000001010010100010010000000101100010001
1000000010001000101101000100001100000110010101100100001101000110000001101101010100001111101100100001
1101011000100000010001101110000000000000000110000010110010110000000010000000000010010010100100010011
1100000011000000001110000001110100100101101010011000001100000100001000100111000111010111010100010011
1111011101010110001001110010100100011010110010001011101000001001100000100110000001000100010100001001
1001011000000000011000000000000001011001000110000001101110000011000010001110111100101001111111000101
1100010100010000110001100111011011101100000000001000010000010000000100000100100000100011100001100001
1011000001000101000100011010000110011001011000000010110000111000100000011000010100110001010011010101
1010010110000011001000000110011001101101001001000011011010001011001000100010011010000011000100011001
1100001111010001001101110001100000001101100000100000010011000010000000101010011000000100100010000011
1100100100001011001100010010110001001000000110110000111000000100110101010011101110101110000101101011
1010001100000110000010100010000010010010011010101011101100100010011100000100000100001000111000001011
1011001100100010000110101000100100110001111001110000000011000101000001010100100100110001000000100001
1110100000011101100000110000001110010100100000010000000110000000101101100010000100000100000000000101
1011010000010000011010010100000010001000001010000010000100000011000001011001010000000101010100100101
1010100000001101010000000010000111000000011010110000000111100011100001001000100110010000110001110111
1000010101000010000101000100000010100011000110000000110000100010100000010000000101100111000001010101
1010001110001000000010101010110000001101101000010100010111010010011010000111001101100100101001010011
1000101001001000000000100011100001100010001110000000011110000100110001100000111100010101010110101111
1100111011000011100001100100001110000001100001000100000010011011000100100010001000000001011010100101
1101001110010011110010100110000001000000100011000000000010100001111010010000100001000001100001011011
1101001001010001100001001000011010010010000000101000010101101100100001001000100001000010110000101101
1011011000001000000010000010000101010010001101001000011000010110000101000000001110011000011000100101
1010010100000110010111001110000100000100001010100110000000000100000000000000011010110000101101101011
1000100000001100100110001100011000100100010101000000010000100000000100010000000100001110001011100001
1110001100001000101101000111000000100001000010000011101011110001110000100011000100010001100101100101
1010000011111100100000000101000010110001101011001101000000101000000000000000101011010010010110000001
1101101000000100100011001100101010000110000000001010000110001110000001101000100100000011100100101101
1100001010010101000000001010000101010111001001001001011110100011010100000000001000101000000000001011
1000111000101000000000011000011000001100000001000010000000100010111110100010100000011000010000000001
1011010001000000001001010111001010000000000010111000001100010010000000000101001011010011101100011101
1001001010000000001100110000000000100010001101001100000000100100001110100010001001100000010110010101
1100011100100111110000001100000000000010000000000000010010000000011011000000001000000111001000101101
1101001100110100001000100010101001000100101000011110011000001100111011000001110100001101011001001011
1000010001010011000101011110000001111110101011001110000011000010000101100101011010000000000001100001
1001000111101000001000000000100101101001100000110000000101100000111110010000000110001111110101110101
1111111111111111111111111111111111111111111111111111111111111111111111111111111111111111111111111111