EA ./path_to_the_east_texture
NO ./path_to_the_north_texture
SO ./path_to_the_south_texture
WE ./path_to_the_west_texture


F 233,113,0
C 225,30,0

    1111111
    1001111
1111001
100S 01
1000001
1111111