
EA ./textures/leaves.xpm
NO ./textures/wood.xpm
SO ./textures/Brick_Grey.xpm
WE ./textures/Concrete_Lines_Grey.xpm
DO ./textures/metal_door.xpm



F 108,100,100


C 128,255,190

111111111111111111111111111111
101000000000000000000000000001
10D000N000000000000000000000001
1010100010111111111D100000000011
10000100100000101111111111111001
101D1000101000101000001000001011
1100000010100010111010101000101
100000001011111D1 1D111D1111101
11000000100000001 1000000000D01
 1111111111111111 111111111111
11111
