EA ./textures/leaves.xpm
NO ./textures/Brick_Grey.xpm
SO ./textures/Brick_Grey.xpm
WE ./textures/Concrete_Lines_Grey.xpm
DO ./textures/metal_door.xpm

V

F 100,100,100
C 128,255,190

1111111111111111111111111111111
1010000000000000000000000000001
10D0E00000000000000000000000001
1010000010111111111D10000000001
1000000010000010111111111111101
101D100010100010100000100000101
1000000010100010111010101000101
100000001011111D1 1D111D1111101
10000000100000001 1000000000D01
11111111111111111 1111111111111
