EA ./textures/leaves.xpm
NO ./textures/Brick_Grey.xpm
SO ./textures/Brick_Grey.xpm
WE ./textures/Concrete_Lines_Grey.xpm
DO ./textures/wood.xpm

F 100,100,100
C 128,255,190

1111111111111111111111111111111
1000000000000000000000000000001
1000W00000000000000000000000001
1000000010111111111000000000001
1000000010000010111111111111101
101D100010100010100000100000101
1000000010100010111010101000101
10000000101111101 1011101111101
10000000100000001 1000000000001
11111111111111111 1111111111111
